wwwwwwwwwwwwwww
w             w
w            Dw
w       p     w
w             w
w             w
w             w
w             w
wwwwwwwwwwwwwww